1111111111111111111111111111
100010C000000000000000000001
1000111000000000000000000001
1P000000000000000P0000000001
1000000000E00000000000000001
100C000000000000000000000001
11111111111P1111111111111111
