1111111111111111111
1P00000000C000000E1
1000000000000000001
1000000000000000001
10000C0C0C0C0000001
10000C0C0C0C0000001
10000C0C0C0C0000001
10000C0C0C0C0000001
10000C0C0P0C0000011
10000C0C0C0C0000001
10000C0C0C0C00L00E1
1111111111111111111
