11111111111111111111111111111111111111111
100000000000C0000000000000000000000000001
10000000000000000000000000000000000000001
1000000P000000000000000000000000000000001
10000000000000000P00000000000000000000001
10000000000000000000000000000000000000001
10000000000000000000000000000000000000001
10000000000000000P00000000000000000000001
1000000000000000000000000P000000000000001
10000000000000000000000P00000000000000001
10000000000000000000000000000000000000001
1000000E000000000000000000000000000000001
10000000000000000000000000000000000000001
10000000000000000000000000000000000E00001
100000000000C0000000000000000000000000001
10000000000000000000000000000000000000001
1000000P000000000000000000000000000000001
10000000000000000P00000000000000000000001
10000000000000000000000000000000000000001
10000000000000000000000000000000000000001
10000000000000000P00000000000000000000001
1000000000000000000000000P000000000000001
10000000000000000000000P00000000000000001
10000000000000000000000000000000000000001
1000000E000000000000000000000000000000001
10000000000000000000000000000000000000001
10000000000000000000000000000000000E00001
100000000000C0000000000000000000000000001
10000000000000000000000000000000000000001
1000000P000000000000000000000000000000001
10000000000000000P00000000000000000000001
10000000000000000000000000000000000000001
10000000000000000000000000000000000000001
10000000000000000P00000000000000000000001
1000000000000000000000000P000000000000001
10000000000000000000000P00000000000000001
10000000000000000000000000000000000000001
1000000E000000000000000000000000000000001
10000000000000000000000000000000000000001
10000000000000000000000000000000000E00001
11111111111111111111111111111111111111111
