11111111111111111111111111111111111111111
10000000000000000000000000000000000000001
10000P000000000000000000000000000000E0001
1000000000000000000C000000000000000000001
11111111111111111111111111111111111111111
